################################
#.............#.P.#............#
#.............#...#............#
#.............#.###............#
#.............#...#............#
#.............#...#............#
#.............###.#............#
#.............#...#............#
################################