################################
#P..........##.................#
#.###..############..###..####.#
#.#...#.............#..........#
#.#.###..#####..###.###..##..#.#
#.#.....#....#.........#..#....#
#.#..#####.#####..###..###..####
#.#..#.......#...#.....#.....#.#
#.#..#..###..#####..###..#####.#
#.#..#..#.........#.....#......#
#.#..###..###..#####..###..###.#
#.#.....#.................#....#
#.##########..#####..##.#####..#
#.##########..#####..##.#####..#
#..........#..#.........#......#
#..#####..###..###..###..####..#
#..#.......#.#..............#..#
#.###..###..###..#########..####
#...#.............#.........#..#
#.#.###..###..###..###..###..#.#
#.#..#....#.........#..........#
#.#..###..#####..#######..####.#
#...#..........#.............#.#
#.#..##..######.###########..#.#
#.....#...#.................#..#
#.###.###.#####..###..##.###..##
#.#...........#.........#....#.#
#.#########..###########..##..##
#.#########..###########..##..##
#..........#.................#.#
#..#######..###..#..#..###..####
#..#######..###..#..#..###..####
################################
